00000000000000000000000000000000000000000000000000000000000
00000000000000000000000000000000000000000000000000000000000
00000000000000000000000000000000000000000000000000000000000
00000000000000000000000000000000000000000000000000000000000
00000002222200000000000000000000000000000000000000000000000
00000000000000000000000000000022222220000000000000000000000
22000000000000000220000002200000000000000022200000000000000
11222222222222222110000221120000000000022211122222000000000
11111111111111111110000111110000000000000111111000000000000
11111111111111111110000011000000000000000000000000000000000
11111111111111111110000010000000000000000000000000000000000
11111111111111111110000010000000000000000000000000000000000
11111111111111111110000000000000000000000000000000000000000